111111110001111000000000100005
012000000101000211110110021100
000111110100011000110011101110
110000110110111110011013101100
310110110200000011110000000021
000102011011111000111111110101
101101011000021310110110000101
020101011011101110100010111101
010111000000100010121000100001
010000011110001000001110001111