000102100001100000000111100000
010101101100201111110010001010
010000001111011000011010111110
011111141001010011001000121400
201111111101010111101110101110
100001000001012100001300100000
111101111011011121111111110111
000101000001000001000001000112
050021011101111111011101010000
000100000102000000012000011111