                        --------------------------------                                  
                        |    RRRR     YYYY     GGGG    |                                  
                        |    RRRR     YYYY     GGGG    |                                  
                        |    RRRR     YYYY     GGGG    |                                  
                        --------------------------------                                  
              --------------------------------------------------------------              
              |                                                            |              
              |                             P                              |              
              |                                                            |              
              |                                                            |              
              |                                                            |              
              |                                                            |              
              |                                                            |              
              |                                                            |              
              |                                                            |              
              |                                                            |              
              |                                                            |              
              |                                                            |              
              |                                                            |              
              |                                                            |              
              |                                                            |              
              |                                                            |              
              |                                                            |              
              |                                                            |              
              |WWWWWWWWWWWWWWWWWWWWWWWWWWWWWWWWWWWWWWWWWWWWWWWWWWWWWWWWWWWW|              
              |                                                            |              
              |                                                            |              
              |                                                            |              
              |                                                            |              
              --------------------------------------------------------------              
                                                                                          
                                                                                          
                                                                                          
                                                                                          
                                                                                          