                        --------------------------------                                  
                        |    RRRR     YYYY     GGGG    |                                  
                        |    RRRR     YYYY     GGGG    |                                  
                        |    RRRR     YYYY     GGGG    |                                  
                        --------------------------------                                  
              --------------------------------------------------------------              
              |              W                                             |              
              |              W                                             |              
              |              W                                             |              
              |              W                                             |              
              |              W                                             |              
              |              W                                             |              
              |              W                                             |              
              |              W                                             |              
              |11111111111111111111111111111111111111111111111             |              
              |                                                            |              
              |                                                            |              
              |                                                            |              
              |                                                            |              
              |                                                            |              
              |                                                            |              
              |                                                            |              
              |                                                            |              
              |                                                            |              
              |                                                            |              
              |                                                            |              
              |      P                                                     |              
              |                                                            |              
              |                                                            |              
              --------------------------------------------------------------              
                                                                                          
                                                                                          
                                                                                          
                                                                                          
                                                                                          