010010211011111100011011110010
011011000010000001010010010110
000000010110111101110110110000
211111110000100100020000011112
001000111101101110101111000010
101010001000100010100001111000
001111011010110110111100011110
011000001010000000000111010000
001011100011011101110001010111
500010001001000101400100010020